[spacy_lookups]
bn = spacy_lookups_data:bn
ca = spacy_lookups_data:ca
da = spacy_lookups_data:da
de = spacy_lookups_data:de
de_extra = spacy_lookups_data:de_extra
el = spacy_lookups_data:el
el_extra = spacy_lookups_data:el_extra
en = spacy_lookups_data:en
en_extra = spacy_lookups_data:en_extra
es = spacy_lookups_data:es
es_extra = spacy_lookups_data:es_extra
fa = spacy_lookups_data:fa
fr = spacy_lookups_data:fr
hr = spacy_lookups_data:hr
hu = spacy_lookups_data:hu
id = spacy_lookups_data:id_
it = spacy_lookups_data:it
lb = spacy_lookups_data:lb
lt = spacy_lookups_data:lt
nb = spacy_lookups_data:nb
nl = spacy_lookups_data:nl
pl = spacy_lookups_data:pl
pt = spacy_lookups_data:pt
ro = spacy_lookups_data:ro
ru = spacy_lookups_data:ru
sr = spacy_lookups_data:sr
sv = spacy_lookups_data:sv
ta = spacy_lookups_data:ta
th = spacy_lookups_data:th
tl = spacy_lookups_data:tl
tr = spacy_lookups_data:tr
ur = spacy_lookups_data:ur

